--------------------------------------------------------------------------------------------------------------------------------------------------------------------------------------------------------
--------------------------------------------------------------------------------------------------------------------------------------------------------------------------------------------------------
--------------------------------------------------------------------------------------------------------------------------------------------------------------------------------------------------------
--------------------------------------------------------------------------------------------------------------------------------------------------------------------------------------------------------
--------------------------------------------------------------------------------------------------------------------------------------------------------------------------------------------------------
--------------------------------------------------------------------------------------------------------------------------------------------------------------------------------------------------------
--------------------------------------------------------------------------------------------------------------------------------------------------------------------------------------------------------
-------------------------------?-------X----------M-?X------------------------------?----------------------?--------------?------?-------------o-------------------M------------------------------?----v
-------------------------------------------------?----B-----------------T-?--B----?-------------o----------------------------o-----------------M---------------------------o-------------?------------Bf
---------?-------?------?o-?-------------M--T----------------X----------|----------?----M--B--------?--M--o----------?-----------------E-------------------------B------------------o----?-----------?-f
----------?------------------B-?----------o-|------?-----T--------------|--------------------?----?---T----------------------X---------?-M------o?-?---------------------------?-----------------------f
------------------o------T---|--------------|------------|T------------T|--------?-------------------T|-?--------E-----o---------T------------------------E------------------o-------------------------f
---------------------T---|---|---T---------?|--E--------?||---?--------||-------X--------------o-----||------?--T----------------|-?--------------------?-|----o---T-?--o?----T-T---------------?------f
----------?-T----T---|--?|--T|---|--?--M----|T------E----||----------T?||----?---------T-------?B----||---------|---------------E|-----------------T------|--------|-?------?T|-|-------B--------------f
m--E--TT----|----|XE-|---|-T||--E|-X|-?-T-B-||?-----X-EE-||-M------TX|-||--TT--T-----?-|?-T-?-E-|T---||--------?|-----T----TT---||----B---X--------|--E-TE|-T------|---T--Eo-||E|---E-B-TXB------B-----X
XXXXXXXXXXXXXXXXXXXXXXXXXXXXXXXXXXXXXXXXXXXXXXXXXXXXXXXXXXXXXXXXXXXXXXXXXXXXXXXXXXXXXX-XXXXXXXXXXXXXXXXXXXXXXXXXXXXXXXXXXXXXXXXXXXXXXXXXXXXXXXXXXXXXXXXXXXXXXXXXXXXXXXXXXXXXXXXXXXXXXXXXXXXXXXXXXXXXXXXX
