----------------------------------------------------------------------------------------------------------------------------------B---------------------------------------------------------------------
--------------o---------------------------------------------------------------------------------------------------------------------------------------------------------------------o-------------------
---------------------o----------------------------------------------------------------------------------------------------------------------------------------------------------------------------------
-------------------------------------------------------------------------------M--------------------------------M---------------------------------o-----------------------------------------------------
------------------------------------------------------------------------------------------------------------------------------X----B--------------------------------------------------------------------
----------X------------------------------------------------------------------------------------?-----------?-----------------XX---o---------------------------------------------------------------------
---------------?---------------------------------------------------------------------------------------o-----B--------------XXX----------?--------------------------------------------------------------
------M-----B----------------------------------------------------------------------------------------------------X---------XXXX-------------------------T-----------------------------?----------------v
--------------------------------------------------------------------------------------------------------------------------XXXXX-------------------------|----------------------------------------------f
------------------------o---BBB---?---------------------------------------------------XXXXXXX----------------------------XXXXXX------------------?????--|----------------------------------------------f
------------------------------------------------------------------------------------------------------------------------XXXXXXX-------------------XXXXXX|X----------------X--?-------------------------f
--------------?----------------------------------------------T--------------------------------------T------------------XXXXXXXX-------------------------|----------------X------------?----------------f
------o-----X------XXX----------------------------X----------|-----------------------------X--------|-----------------XXXXXXXXX-------------------------|---------------XX-----------------------------f
------------XX-----------------------------------------------|---M----------------------------------|----------------XXXXXXXXXX-------------------------|--------------XXX-----------------------------f
m----------EXXX---E------------------------------------------|X---------E------XX----------------E--|-----------E---XXXXXXXXXXX---------B---E-----------|-------------XXXX-----------------------------X
XXXXXXXXXXXXXXXX------XXXXXXXXXXXXX--------XXXXMXXXXXXXXXXXXX|------------XXXXXXXX-XXXXXXXX------XXX|XXXXXXXXXXXXXXXXXXXXXXXXXXXXXX--XXXXXXXXX--XXXXXXXX|XXXXXXMXXXXXXXXXXXXXXXXXXXXXXXXXXXXXXXXXXBBBBBX
