--------------------------------------------------------------------------------------------------------------------------------------------------------------------------------------------------------
-------------------------------------------------------------------------------------------------------------------------------------------------------------------------------------o------------------
----------------------------------------------------------------------------------------------------------------XXX----------------B--------------------------------------------------------------------
--------------------------------------------------------------------------------------------------------------------------------------------------------------------------------------------------------
------------------------------------------------------------------------------------------------------X-------------------------------------------------------------------------------------------------
------------------------------X----------------------------------------------------------------------XX--------------------X-------B--------------------------------------------------------------------
-----------------------------XX---------------------------------------------------------------------XXX---------------X---------------------------------------------------------------------------------
----------------------------XXX--------------------------------------------------------------------XXXX---------XXX--XX----X---------------------------------------------------------------------------v
---------------------------XXXX-------------------------------------------------------------------XXXXX-------------XXX--------------------------------------------------------------------------------f
--------------------------XXXXX------------------------------------------------------------------XXXXXX------------XXXX----X---------------------------------------------------------------------------f
-------------------------XXXXXX-----------------------------------------------------------------XXXXXXX-----------XXXXX--------------------------------------------------------------------------------f
------------------------XXXXXXX-------------------------B--------------------------------------XXXXXXXX----------XXXXXX-----------------------------------------------------X--------------------------f
-----------------------XXXXXXXX-----------------------------------------------T---------------XXXXXXXXX---------XXXXXXX-----------------------------B----------------------XX--------------------------f
----------------------XXXXXXXXX-----------------------------------------------|--------------XXXXXXXXXX--------XXXXXXXX---------------------------------------------------XXX--------------------------f
m----------E---------XXXXXXXXXX-----------------------------------------------|---E---------XXXXXXXXXXX-------XXXXXXXXX--------------------------------------------------XXXX--------------------------X
XXXXXXXXXXXXXXXXXXXXXXXXXXXXXXXXXXXXXXXXXXXXXXXXXXXXXXXXXXXXXXXXXXXXXXXXXXXXXX|XXXXXXXXXXXXXXXXXXXXXXXXXXXXXXXXXXXXXXXXXXXXXXXXXXXXXXXXXXXXXXXXXXXXXXXXXXXXXXXXXXXXXXXXXXXXXXXXXXXXXXX----XXXXXXXXXXXXXX
