--------------------------------------------------------------------------------------------------------------------------------------------------------------------------------------------------------
--------------------------------------------------------------------------------------------------------------------------------------------------------------------------------------------------------
--------------------------------------------------------------------------------------------------------------------------------------------------------------------------------------------------------
--------------------------------------------------------------------------------------------------------------------------------------------------------------------------------------------------------
--------------------------------------------------------------------------------------------------------------------------------------------------------------------------------------------------------
--------------------------------------------------------------------------------------------------------------------------------------------------------------------------------------------------------
--------------------------------------------------------------------------------------------------------------------------------------------------------------------------------------------------------
---X--o------Xo-o-----o--------X-?--o--?---?--------X---X----------------o-X--o--o-------------o--B---oX-----X----o-X--?B--oX--X----X-Xo--oB--------M--------M------M-------oX--X-------------B--o---?Xv
-o---X-----o------X---X--------------BEM-----X--XB-------X----X------X---o-----X--------o-----------X---X----o-------Boo---?--B---o-X--------B-o-----o-T---------X-o---------------B---X--B-o--oT-o--X-f
-X-ooXM---X-----X-o--M----------------X---------T--X--T----T-------o--------o-?---T------o---------------XX----------X------X-----oB-??--B---o----o----|---B--------XT---o---------------X------|--TTB-f
-------B-o--o---------------X-------------o-----|--X--|----|B-o-------XX----------|B-B------Bo-X-X-----B-oo---X-----X---Xo--------?-------X------B-----|X-o--X--B----|---o--o--B--B-------X--X--|--||-of
-----B------M-o-----B--o--o--XB-------------X---|-o---|---X|-B-------------B--X-?-|----X--o------X--------?--o--B--Mo-o-X----------B----------X--------|Bo-----o-X---|-o---B--------------------|--||-of
---T----?-------o-Bo-----X-?-?o--------X------B-|-----|----|-oB------------o---?--|--------B-X-----o----o----------------oX-----?-----o-----------X----|-------X--o--|--X----B-o--B----o--------|--||--f
---|-----X--------------------------o----?XX----|o---X|X-o-|--?-XoB-------o---B---|---B-X-o----B---o-----------------X----------?------o---T-----------|--o----o-----|-----M--------------TXo---|XX||--f
m--|------?--o-T----TTo---TTET-----T-TXXX-----XX|--Too||---|?-XTT-----T-ToB-T-|-B-|---TT|-X-E-Bo---X-T-B--------T-T---T--E--o---X---X-BT---|-X---X-----|-o----B|?----|-TT----T?-----?oXo--|o--T-|B-||--X
XXXXXXXXXX-XX-X-XXX-XXXX-XXXXXXXXXXXXX--XXXXXXXXXXXXX-XXXXXXXX-XXXXXXXXXXXX-XXXXXXXXXX-XXXXX-XXXXX-XXXXXXX-XX-X-XXXXo-XXXX-XXXXXXXXXXX-XXXXX-XXX-X-X-X-XX-X-XX-XXXX-XXXXXXXX-XXX-XXXXXX-XXXX--XoXoXX|-XX
